0 0 0 0 0 0 0 0 0 0 0 0 0 0 0 0 0 0 0 0 0 0 0 0 0 0 0 0 0 0 0 0 
0 0 0 0 0 0 0 0 0 0 0 0 0 0 0 0 0 0 0 0 0 0 0 0 0 0 0 0 0 0 0 0 
0 0 0 0 0 0 0 0 0 0 0 0 0 0 0 0 0 0 0 0 0 0 0 0 0 0 0 0 0 0 0 0 
0 0 0 0 0 0 0 0 0 0 0 0 0 0 0 0 0 0 0 0 0 0 0 0 0 0 0 0 0 0 0 0 
0 0 0 0 0 0 0 0 0 0 0 0 0 0 0 0 0 0 0 0 0 0 0 0 0 0 0 0 0 0 0 0 
0 0 0 0 0 0 0 0 0 0 0 0 0 0 0 0 0 0 0 0 0 0 0 0 0 0 0 0 0 0 0 0 
0 0 0 0 0 0 0 0 0 0 0 0 0 0 0 0 0 0 0 0 0 0 0 0 0 0 0 0 0 0 0 0 
0 0 0 0 0 0 0 0 0 0 0 0 0 0 0 0 0 0 0 0 0 0 0 0 0 0 0 0 0 0 0 0 
0 0 0 0 0 0 0 1042 1044 0 0 0 0 0 0 0 0 0 0 0 0 0 0 0 0 0 0 0 0 0 0 0 
0 0 0 0 0 0 0 1045 1047 0 0 0 0 0 0 0 0 0 0 0 0 0 0 0 0 0 0 0 0 0 0 0 
0 0 0 0 0 0 0 1045 1047 0 0 0 0 0 0 0 0 0 0 0 0 0 0 0 0 0 0 0 0 0 0 0 
0 0 0 0 0 0 0 1045 1053 1044 0 0 1042 1043 1043 1043 1044 0 0 0 0 0 0 0 0 0 0 0 0 0 0 0 
0 0 0 0 0 0 1042 1054 1046 1047 0 0 1045 1046 1046 1051 1050 0 0 0 0 0 0 0 0 0 0 0 0 0 0 0 
0 0 0 0 0 0 1045 1046 1046 1053 1044 0 1045 1046 1046 1047 0 0 0 0 0 0 0 0 0 0 0 0 0 0 0 0 
0 0 0 0 0 0 1045 1046 1046 1046 1053 1043 1054 1046 1046 1047 0 0 0 0 0 0 2005 2005 0 0 0 0 0 0 0 0 
0 0 0 0 0 0 1045 1046 1046 1046 1046 1046 1046 1046 1046 1047 0 0 0 0 0 0 0 0 0 0 0 0 0 0 0 0 
1014 0 0 0 0 0 1046 1046 1046 1046 1046 1046 1046 1046 1046 1047 0 0 0 0 0 0 0 0 0 0 0 0 0 0 0 0 
1017 0 0 0 0 1045 1046 1046 1046 1046 1046 1030 1046 1046 1046 1047 0 0 0 0 0 0 0 0 0 0 0 0 0 0 0 0
 