0 0 0 0 0 0 0 0 0 0 0 0 0 0 0 0 0 0 0 0 0 0 0 0 0 0 
0 0 0 0 0 0 0 0 0 0 0 0 0 0 0 0 0 0 0 0 0 0 0 0 0 0 
0 1000 1001 1001 1002 0 0 0 0 0 0 0 0 0 0 0 0 0 0 0 0 0 0 0 0 0 
0 1003 1004 1004 1005 0 0 0 0 0 0 0 0 0 0 0 0 0 0 0 0 0 0 0 0 0 
0 1003 1004 1004 1005 0 0 0 0 0 0 0 0 0 0 0 0 0 0 0 0 0 0 0 0 0 
0 1006 1007 1007 1008 0 0 0 0 0 0 0 0 0 0 0 0 0 0 0 0 0 0 0 0 0 
0 0 0 0 0 0 0 0 0 0 0 0 0 0 0 0 0 0 0 0 0 0 0 0 0 0 
0 0 0 0 0 0 0 0 0 0 0 0 0 0 0 0 2000 1001 1001 1001 1002 0 0 0 0 0 
0 0 0 0 0 0 0 0 0 0 1 0 0 0 0 2000 1012 1004 1004 1004 1005 0 0 0 0 0 
0 0 0 0 0 0 0 0 0 0 0 0 0 0 2000 1012 1004 1004 1004 1004 1005 0 0 0 0 0 
0 0 0 0 0 0 0 0 1000 1001 1001 1001 1001 1001 1001 1001 1001 1001 1001 1001 1001 1002 0 0 0 0 
0 0 0 0 0 0 0 0 1003 1004 1004 1004 1004 1004 1004 1004 1004 1004 1004 1004 1004 1005 0 0 0 0 
0 0 0 1000 1002 0 0 0 1003 1004 1004 1004 1004 1004 1004 1004 1004 1004 1004 1004 1004 1005 0 0 0 0 
0 0 0 1003 1005 0 0 0 1003 1004 1004 1004 1004 1004 1004 1004 1004 1004 1004 1004 1004 1005 0 0 0 0 
