1033 1033 1034 0 0 0 0 0 0 0 0 0 0 0 0 0 0 995 995 995 0 0 0 0 0 0 0 1016 1017 1017 1017 1017 
1033 1033 1034 0 0 0 0 0 0 0 0 0 0 0 0 0 0 0 0 0 0 0 0 0 0 0 0 1016 1017 1017 1017 1017 
1033 1033 1034 0 0 0 0 0 0 0 0 0 0 0 0 0 0 0 991 0 0 0 0 0 0 0 0 1019 1023 1017 1017 1017 
1033 1033 1034 0 0 0 0 0 0 0 0 0 0 0 0 0 0 0 0 0 0 0 0 0 0 0 0 0 1019 1020 1023 1017 
1033 1033 1034 0 0 0 0 0 0 0 0 0 0 0 0 0 1026 1027 1027 1027 1028 0 0 0 0 0 0 0 0 0 1016 1017 
1033 1033 1034 0 0 0 0 0 0 0 0 0 0 0 0 0 0 0 0 0 0 0 0 0 0 0 0 0 0 0 1016 1017 
1033 1033 1034 0 0 0 0 0 0 0 0 0 0 0 0 0 0 0 0 0 0 0 0 0 0 0 0 0 0 0 1019 1023 
1033 1038 1037 0 0 0 0 0 0 0 0 0 0 0 0 0 0 0 0 0 0 0 1026 1028 0 0 0 0 0 0 0 1016 
1033 1034 0 0 0 0 0 0 0 0 0 0 0 0 0 0 0 0 0 0 0 0 0 0 0 0 0 0 0 0 0 1016 
1033 1034 0 0 0 0 0 0 0 0 0 0 0 0 0 0 0 0 0 0 0 0 0 0 0 0 0 0 0 0 0 1016 
1033 1034 0 0 0 0 0 0 0 0 0 0 0 0 0 0 0 0 1026 1028 0 0 0 0 0 0 0 0 0 0 0 1019 
1033 1034 0 0 0 0 0 0 3003 3004 3004 3003 0 0 0 0 0 0 0 0 0 0 0 0 0 0 0 0 0 0 0 999 
1033 1034 0 0 0 0 0 0 1029 1030 1030 1031 0 0 0 0 0 0 0 2 0 0 0 0 0 0 0 0 0 994 0 999 
1036 1037 0 0 0 0 0 0 1035 1036 1036 1037 0 0 0 0 0 0 0 0 0 0 1026 1028 0 0 0 0 0 0 0 999 
998 0 0 0 0 0 0 0 0 0 0 0 0 0 0 0 0 0 0 0 0 0 0 0 0 0 0 0 1029 1030 1030 1030 
998 0 993 0 0 0 0 0 0 2 0 0 0 0 0 0 1 0 0 3000 0 0 0 0 0 0 0 1029 1041 1033 1033 1033 
998 0 0 0 0 0 0 0 0 0 0 0 0 0 0 0 0 0 0 0 0 0 0 0 0 0 1029 1041 1033 1033 1033 1033 
1014 1014 1014 1014 1014 1014 1014 1014 1014 1014 1014 1014 1014 1014 1014 1014 1014 1014 1014 1014 1014 1014 1014 1014 1014 1014 1014 1014 1014 1014 1014 1014 
1046 1046 1046 1046 1046 1046 1046 1046 1046 1046 1046 1046 1046 1046 1046 1046 1046 1046 1046 1046 1046 1046 1046 1046 1046 1046 1046 1046 1046 1046 1046 1046 
1049 1052 1046 1046 1046 1046 1046 1046 1046 1046 1046 1046 1046 1046 1046 1046 1046 1046 1046 1046 1046 1046 1046 1046 1046 1046 1046 1046 1046 1046 1046 1046 
0 1048 1052 1046 1046 1046 1046 1046 1046 1046 1046 1046 1046 1046 1046 1046 1046 1046 1046 1046 1046 1046 1046 1046 1046 1046 1046 1046 1046 1046 1046 1046 
0 0 1048 1049 1049 1049 1049 1049 1049 1049 1049 1052 1046 1046 1046 1046 1046 1046 1046 1046 1046 1046 1046 1046 1046 1046 1051 1049 1049 1049 1052 1046 
0 0 0 0 0 0 0 0 0 0 0 1048 1052 1046 1046 1046 1046 1046 1046 1046 1046 1046 1046 1046 1046 1051 1050 0 0 0 1048 1049 
0 0 0 0 0 0 0 0 0 0 0 0 1048 1049 1049 1049 1052 1046 1046 1046 1046 1046 1051 1049 1049 1050 0 0 0 0 0 0 
0 0 0 0 0 0 0 0 0 0 0 0 0 0 0 0 1048 1052 1046 1046 1046 1051 1050 0 0 0 0 0 0 0 0 0 
0 0 0 0 0 0 0 0 0 0 0 0 0 0 0 0 0 1048 1049 1049 1049 1050 0 0 0 0 0 0 0 0 0 0 
0 0 0 0 0 0 0 0 0 0 0 0 0 0 0 0 0 0 0 0 0 0 0 0 0 0 0 0 0 0 0 0 
0 0 0 0 0 0 0 0 0 0 0 0 0 0 0 0 0 0 0 0 0 0 0 0 0 0 0 0 0 0 0 0 
0 0 0 0 0 0 0 0 0 0 0 0 0 0 0 0 0 0 0 0 0 0 0 0 0 0 0 0 0 0 0 0 
998 0 0 0 0 0 0 0 0 0 0 0 0 0 0 0 0 0 0 0 0 0 0 0 0 0 0 0 0 0 0 999 
998 0 993 0 0 0 0 0 0 2 0 0 0 0 0 0 0 0 0 0 0 0 0 0 0 0 0 0 0 994 0 999 
998 0 0 0 0 0 0 0 0 0 0 0 0 0 0 0 0 0 0 0 0 0 0 0 0 0 0 0 0 0 0 999 
1014 1014 1014 1014 1014 1014 1014 1014 1014 1014 1014 1014 1014 1014 1015 0 0 0 0 0 1013 1014 1014 1014 1014 1014 1014 1014 1014 1014 1014 1014 
0 0 0 0 0 0 0 0 0 0 0 0 0 0 1018 992 0 0 0 1013 0 0 0 0 0 0 0 0 0 0 0 0 
0 0 0 0 0 0 0 0 0 0 0 0 0 0 0 1015 0 0 0 1016 0 0 0 0 0 0 0 0 0 0 0 0 
0 0 0 0 0 0 0 0 0 0 0 0 0 0 0 1018 997 997 997 1016 0 0 0 0 0 0 0 0 0 0 0 0 
0 0 0 0 0 0 0 0 0 0 0 0 0 0 0 0 1005 995 995 995 1003 0 0 0 0 0 0 0 0 0 0 0 
0 0 0 0 0 0 0 0 0 0 0 0 0 0 0 0 1005 0 0 0 1003 0 0 0 0 0 0 0 0 0 0 0 
0 0 0 0 0 0 0 0 0 0 0 0 0 0 0 0 1005 991 0 0 1003 0 0 0 0 0 0 0 0 0 0 0 
0 0 0 0 0 0 0 0 0 0 0 0 0 0 0 0 1005 0 0 0 1003 0 0 0 0 0 0 0 0 0 0 0 
0 0 0 0 0 0 0 0 0 0 0 0 0 0 0 0 1011 1002 0 0 1003 0 0 0 0 0 0 0 0 0 0 0 
0 0 0 0 0 0 0 0 0 0 0 0 0 0 0 0 1009 1008 0 0 1003 0 0 0 0 0 0 0 0 0 0 0 
0 0 0 0 0 0 0 0 0 0 0 0 0 0 0 0 1005 0 0 0 1003 0 0 0 0 0 0 0 0 0 0 0 
0 0 0 0 0 0 0 0 0 0 0 0 0 0 0 0 1005 0 0 0 1003 0 0 0 0 0 0 0 0 0 0 0 
0 0 0 0 0 0 0 0 0 0 0 0 0 0 0 0 1005 0 0 1000 1012 0 0 0 0 0 0 0 0 0 0 0 
0 0 0 0 0 0 0 0 0 0 0 0 0 0 0 0 1005 0 0 1006 1010 0 0 0 0 0 0 0 0 0 0 0 
0 0 0 0 0 0 0 0 0 0 0 0 0 0 0 0 1005 0 0 0 1006 1007 1007 1007 1007 1007 1007 1007 1007 1007 1007 1007 
0 0 0 0 0 0 0 0 0 0 0 0 0 0 0 0 1005 0 0 0 0 0 0 0 0 0 0 0 0 0 0 999 
0 0 0 0 0 0 0 0 0 0 0 0 0 0 0 0 1011 1002 0 0 0 0 0 0 0 0 0 0 0 994 0 999 
0 0 0 0 0 0 0 0 0 0 0 0 0 0 0 0 0 1005 0 0 0 0 0 0 0 0 0 0 0 0 0 999 
0 0 0 0 0 0 0 0 0 0 0 0 0 0 0 0 0 1011 1001 1001 1001 1001 1001 1001 1001 1001 1001 1001 1001 1001 1001 1001 
0 0 0 0 0 0 0 0 0 0 0 0 0 0 0 0 0 0 0 0 0 0 0 0 0 0 0 0 0 0 0 0 
0 0 0 0 0 0 0 0 0 0 0 0 0 0 0 0 0 0 0 0 0 0 0 0 0 0 0 0 0 0 0 0 
0 0 0 0 0 0 0 0 0 0 0 0 0 0 0 0 0 0 0 0 0 0 0 0 0 0 0 0 0 0 0 0 
