1051 1049 1049 1052 1051 1049 1049 1049 1052 1046 1046 1046 1046 1046 1046 1046 1046 1046 1046 1046 1046 1046 1046 1046 1046 1046 1046 1046 1046 1046 1046 1046 
1050 0 0 1048 1050 0 0 0 1048 1052 1046 1046 1046 1046 1051 1049 1049 1052 1046 1046 1046 1046 1046 1046 1051 1049 1049 1049 1049 1049 1049 1049 
1005 0 0 0 0 0 0 0 0 1048 1049 1049 1049 1049 1050 0 0 1048 1049 1052 1051 1049 1049 1049 1050 0 0 0 0 0 0 1032
1005 0 0 0 0 0 0 0 0 0 0 0 0 0 0 0 0 0 0 1048 1050 0 0 0 0 0 0 0 0 0 0 1032
1005 0 1 0 0 0 0 0 0 0 0 0 0 0 0 0 0 0 0 0 0 0 0 0 0 0 0 0 0 0 0 1032 
1005 0 0 0 0 0 0 0 0 0 0 0 0 0 0 0 0 0 0 0 0 0 0 0 0 0 0 1032 3 0 0 1032 
1011 1001 1001 1001 1002 0 0 0 0 0 0 0 0 0 0 0 0 0 0 0 0 0 0 0 0 0 0 0 0 0 0 1032 
1009 1007 1007 1007 1008 0 0 0 0 0 0 0 0 0 0 0 0 0 0 0 0 0 0 0 0 0 0 0 1029 1030 1030 1041 
1005 0 0 0 0 0 0 1026 1028 0 0 0 0 0 0 0 0 0 0 0 0 0 0 0 0 0 0 0 1035 1036 1036 1039 
1005 0 0 0 0 0 0 0 0 0 0 0 3002 0 3000 0 3001 0 0 0 0 0 0 0 0 0 0 0 0 0 0 1032 
1005 0 0 0 0 0 0 0 0 0 0 0 0 0 0 0 0 0 0 0 0 0 0 0 0 0 0 0 0 0 0 1032 
1005 0 0 0 0 0 0 0 0 0 0 0 1026 1027 1027 1027 1028 0 0 0 0 0 1029 1031 0 0 0 0 0 0 0 1032 
1005 0 0 0 0 0 0 0 0 0 0 0 0 0 0 0 0 0 0 0 0 0 1032 1034 0 0 0 0 0 0 0 1032 
1005 0 0 2 0 0 0 3004 3004 3004 3004 3004 3004 3003 3003 3003 3003 3003 3003 0 0 0 1032 1034 0 0 0 0 0 0 0 1032 
1005 0 0 1029 1031 0 0 0 0 0 2 0 0 0 0 0 0 0 0 2004 2005 2005 1032 1034 2005 2005 2006 0 0 0 0 1032 
1005 0 1029 1030 1030 1031 0 0 0 0 0 0 0 0 0 0 0 0 0 0 0 0 1032 1034 0 0 0 4 0 0 0 1032 
1005 1014 1014 1014 1014 1014 1014 1014 1014 1014 1014 1015 0 0 0 0 0 0 0 0 0 0 1032 1034 0 0 0 0 0 0 0 1032 
1005 1017 1017 1017 1017 1017 1017 1017 1017 1017 1017 1018 1030 1030 1030 1030 1030 1030 1030 1030 1030 1030 1041 1040 1030 1030 1030 1030 1030 1030 1030 1041 
