0 0 0 0 0 0 0 0 0 0 0 0 0 0 0 0 0 0 0 0 0 0 0 0 0 0 0 0 0 0 0 0 
0 0 0 0 0 0 0 0 0 0 0 0 0 0 0 0 0 0 0 0 0 0 0 0 0 0 0 0 0 0 0 0 
0 0 0 0 0 0 0 0 0 0 0 0 0 0 0 0 0 0 0 0 0 0 0 0 0 0 0 0 0 0 0 0 
1028 0 0 0 0 0 0 0 0 0 0 0 0 0 0 0 0 0 0 0 0 0 0 0 0 0 0 0 0 0 0 0 
1031 0 0 0 0 0 0 0 0 0 0 0 0 0 0 0 0 0 2004 2005 2005 2005 2006 0 0 0 0 0 0 0 0 1013 
1031 0 0 0 0 0 0 0 0 0 0 0 0 0 0 0 0 0 0 0 0 0 0 0 0 0 0 0 0 0 0 1016 
1031 0 0 0 0 0 0 0 0 0 0 0 0 0 0 0 0 0 0 0 0 0 0 0 0 0 0 0 0 0 0 1016 
1031 0 0 0 0 0 0 3000 0 3001 0 3002 0 1 0 0 2004 2005 2005 2005 2006 0 0 0 0 0 0 0 0 0 0 1016 
1031 0 0 0 0 0 0 0 0 0 0 0 0 0 0 0 0 0 0 0 0 0 0 0 0 0 0 0 0 0 0 1016 
1037 1028 0 0 0 1000 1001 1001 1001 1001 1001 1001 1001 1002 0 0 0 0 0 0 0 0 0 0 0 0 0 0 0 0 0 1016 
1035 1034 0 0 0 1003 1009 1007 1007 1007 1007 1007 1007 1008 0 0 0 0 0 0 0 0 0 0 0 0 3 0 0 1013 1014 1025 
1031 0 0 0 0 1003 1005 0 0 0 0 0 0 0 0 0 0 0 0 0 0 0 0 0 0 0 0 0 0 1016 1017 1017 
1031 0 0 0 1000 1012 1005 0 0 0 0 0 0 0 0 0 0 0 0 0 0 0 0 0 0 0 1013 1014 1014 1025 1017 1017 
1031 0 0 0 1006 1010 1005 0 0 0 0 0 0 0 0 0 0 0 0 2 0 0 0 0 0 0 1016 1017 1017 1017 1017 1017 
1031 0 0 0 0 1006 1008 0 0 0 0 0 0 0 0 0 0 0 0 0 0 0 0 0 0 0 1016 1017 1017 1017 1017 1017 
1037 1028 0 0 0 0 0 0 0 0 0 0 4 0 0 0 0 1013 1014 1014 1014 1014 1015 0 0 0 1016 1017 1017 1017 1017 1017 
1030 1031 0 0 0 0 0 0 0 0 0 0 0 0 0 0 0 1016 1017 1017 1017 1017 1018 0 0 0 1016 1017 1017 1017 1017 1017 
1030 1037 1027 1027 1027 1027 1027 1027 1027 1027 1027 1027 1027 1027 1027 1027 1027 1016 1017 1017 1017 1017 1024 1014 1014 1014 1025 1017 1017 1017 1017 1017 
1017 1018 0 0 0 0 0 0 0 0 0 0 0 0 0 0 0 0 0 0 0 0 0 0 0 0 0 0 0 0 1016 1017 
1017 1018 0 0 0 0 0 0 0 0 0 0 0 0 0 0 0 0 0 0 0 0 0 0 0 0 0 0 0 0 1016 1017 
1017 1018 0 0 0 0 0 0 0 0 0 0 0 0 0 0 0 0 0 0 0 0 0 0 0 0 0 0 0 0 1016 1017 
1017 1018 0 0 0 0 0 0 0 0 0 0 0 0 0 0 0 0 0 0 0 0 0 0 0 0 0 0 0 0 1016 1017 
1017 1018 0 0 0 0 0 2 0 0 0 0 0 0 0 0 0 0 0 0 0 0 0 0 0 0 0 0 0 0 1019 1023 
1017 1018 0 0 0 0 0 0 0 0 0 0 0 0 0 0 0 0 0 0 0 0 0 0 0 0 0 0 0 0 0 1016 
1017 1018 0 0 0 0 0 1026 1027 1027 1027 1028 0 0 0 0 0 0 0 0 0 0 0 0 0 0 0 0 0 0 0 1016 
1017 1018 3 0 0 0 0 1032 1033 1033 1036 1037 1028 0 0 0 0 0 0 0 0 0 0 0 0 0 0 0 0 0 0 1016 
1017 1018 0 0 0 0 0 0 0 0 1032 1033 1034 0 0 0 0 0 0 0 0 0 0 0 0 0 0 3002 3001 3000 0 1016 
1017 1024 1014 1015 0 0 0 0 0 0 0 0 0 0 0 1026 1028 0 0 0 0 0 0 0 0 0 0 1013 1014 1014 1014 1025 
1020 1020 1020 1021 0 0 0 0 0 0 0 0 0 0 0 1032 1034 0 0 0 0 0 0 0 0 0 0 1019 1020 1020 1020 1023 
1031 0 0 0 0 0 0 0 0 0 0 0 0 0 0 0 0 0 0 0 1000 1002 0 3 0 0 0 0 0 0 0 1029 
1031 1 0 0 0 0 0 0 0 0 0 0 0 0 0 0 0 0 0 1000 1012 1011 1001 1002 0 0 0 0 0 0 0 1029 
1031 0 0 0 0 0 0 0 0 0 0 0 0 0 0 0 0 0 0 1006 1007 1007 1007 1008 0 0 0 0 0 0 0 1029 
1014 1015 0 0 0 0 0 0 0 0 0 0 0 0 0 0 0 0 0 0 0 0 0 0 0 0 0 0 0 0 1013 1014 
1017 1018 0 0 0 0 0 0 0 4 0 0 0 0 0 1013 1015 0 0 4 0 0 0 0 0 0 0 0 0 0 1016 1017 
1017 1018 0 0 0 0 0 0 0 0 0 0 0 0 1013 1014 1014 1015 0 0 0 0 0 0 0 0 0 0 0 0 1016 1017 
1017 1024 1014 1014 1014 1014 1014 1014 1014 1014 1014 1014 1014 1014 1025 1017 1017 1024 1014 1014 1014 1014 1014 1014 1014 1014 1014 1014 1014 1014 1025 1017 
