0 0 0 0 0 0 0 0 0 0 0 0 0 0 0 0 0 0 0 0 0 0 0 0 0 0 0 0 0 0 0 0 
0 0 0 0 0 0 0 0 0 0 0 0 0 0 0 0 0 0 0 0 2 0 0 0 0 0 0 0 0 0 0 0 
0 0 0 0 0 0 0 0 0 0 0 0 0 0 0 0 0 0 0 0 0 0 0 0 0 0 0 0 0 0 0 0 
0 0 0 0 0 0 0 0 0 0 0 0 0 0 0 0 0 0 0 1000 1001 1002 0 0 0 0 0 0 0 0 0 0 
0 0 0 0 0 0 0 0 0 0 0 0 0 0 0 0 0 0 0 1003 1004 1005 0 0 0 0 0 0 0 0 0 0 
0 0 0 0 0 0 2 0 0 0 0 0 0 0 0 0 0 0 0 1006 1007 1008 0 0 0 0 0 0 0 0 0 1000 
0 0 0 0 0 0 0 0 0 0 0 0 0 0 0 0 0 0 0 0 0 0 0 0 0 0 0 0 0 0 0 1003 
0 0 0 0 0 1000 1001 1002 0 0 0 0 0 0 0 0 0 0 0 0 0 0 0 0 0 0 0 0 0 0 0 1003 
0 0 0 0 0 1003 1004 1005 0 0 0 0 0 0 0 0 0 0 0 0 0 0 0 0 0 0 0 0 0 0 0 1003 
0 0 0 0 0 1003 1004 1011 1002 0 0 0 0 0 0 0 0 0 0 0 0 0 0 0 0 0 0 0 0 0 0 1003 
0 0 0 0 0 1003 1004 1009 1008 0 0 1000 1002 0 0 0 0 0 0 0 0 0 0 0 0 0 0 0 0 2 0 1003 
0 0 0 0 0 1003 1004 1005 0 0 0 1006 1008 0 0 0 0 0 0 0 0 0 0 0 0 0 0 0 0 0 0 1003 
0 0 0 0 0 1003 1004 1005 0 0 0 0 0 0 0 0 0 0 0 0 0 0 0 0 0 0 2000 1001 1001 1001 1001 1012 
0 0 0 0 0 1003 1004 1011 1001 1002 0 0 0 0 0 0 0 0 0 0 0 0 0 0 0 2000 1012 1004 1004 1004 1004 1004 
0 0 0 0 0 1003 1004 1009 1007 1008 0 0 0 0 1 0 0 0 0 0 0 0 0 0 2000 1012 1004 1004 1004 1004 1004 1004 
0 0 0 0 0 1003 1004 1005 0 0 0 0 0 0 0 0 0 0 0 0 0 0 0 2000 1012 1004 1004 1004 1004 1004 1004 1004 
0 0 1000 1001 1001 1001 1001 1001 1001 1001 1001 1001 1001 1001 1001 1001 1002 0 0 0 1000 1001 1001 1012 1004 1004 1004 1004 1004 1004 1004 1004 
0 0 1003 1004 1004 1004 1004 1004 1004 1004 1004 1004 1004 1004 1004 1004 1011 1001 1001 1001 1012 1004 1004 1004 1004 1004 1004 1004 1004 1004 1004 1004 
0 0 0 0 0 0 0 0 0 0 0 0 0 0 0 0 0 0 0 0 0 0 0 0 0 0 0 0 0 0 0 1003 
0 0 0 0 0 0 0 0 0 0 0 0 0 0 0 0 0 0 0 0 0 0 0 0 0 0 0 0 0 0 0 1003 
0 0 0 0 0 0 0 0 0 0 0 0 0 0 0 0 0 0 0 0 0 0 0 0 0 0 0 0 0 0 0 1003 
0 0 0 0 0 0 0 0 0 0 0 0 0 0 0 0 0 0 0 0 0 0 0 0 0 0 0 0 0 0 0 1003 
0 0 0 0 0 0 0 0 0 0 0 0 0 0 0 0 0 0 0 0 0 0 0 0 0 0 0 0 0 0 0 1003 
0 0 0 0 0 0 0 0 0 0 0 0 0 0 0 0 0 0 0 0 0 0 0 0 0 0 0 0 0 0 0 1003 
1015 0 0 0 0 0 0 0 0 0 0 0 0 0 0 0 0 0 0 0 0 0 0 0 0 0 0 0 0 0 0 1003 
1018 0 0 0 0 0 0 0 0 0 0 0 0 0 0 0 0 0 0 0 0 0 0 0 0 0 0 0 0 2004 2006 1003 
1018 0 0 0 0 0 0 0 0 0 0 0 0 0 0 0 0 0 0 0 0 0 0 0 0 0 0 0 0 0 0 1003 
1018 1 0 0 0 0 0 0 0 0 0 0 0 0 0 0 0 0 0 0 0 0 0 0 0 0 0 0 0 0 0 1003 
1018 0 0 0 0 0 0 0 0 0 0 0 0 0 0 0 0 0 0 0 0 0 2 0 0 0 0 0 0 2004 2006 1003 
1014 1015 0 0 0 0 0 0 0 0 0 0 0 0 0 0 0 0 0 0 0 0 0 0 0 0 0 0 0 0 0 1003 
1017 1018 0 0 0 0 0 0 0 0 0 0 0 0 0 0 0 0 0 0 0 1026 1027 1027 1028 0 0 0 0 0 0 1003 
1017 1018 0 0 0 0 0 0 0 0 0 0 0 0 0 0 0 0 0 0 0 1032 1033 1033 1034 0 0 0 0 2004 2006 1003 
1017 1018 0 0 0 0 0 0 0 0 0 0 0 1026 1027 1027 1027 1027 1028 0 0 0 0 0 0 0 0 0 0 0 0 1003 
1017 1018 0 0 2 0 0 0 0 0 0 0 0 1029 1030 1030 1030 1030 1031 0 0 0 0 0 0 0 0 0 0 0 0 1003 
1017 1018 0 0 0 0 0 0 0 0 0 0 0 1029 1030 1030 1030 1030 1031 0 0 0 0 0 0 0 0 0 0 0 0 1003 
1017 1024 1014 1014 1014 1014 1014 1014 1014 1014 1014 1014 1014 1029 1030 1030 1030 1030 1031 1001 1001 1001 1001 1001 1001 1001 1001 1001 1001 1001 1001 1012 
